a - un  
able - capaz  
about - sobre  
above - arriba
actual - actual
actually - en realidad  
after - después  
again - otra vez  
against - contra  
agree - estar de acuerdo  
agreed - acordado  
all - todo  
allow - permitir  
allowed - permitido  
allowing - permitiendo  
almost - casi  
already - ya  
also - también  
although - aunque  
always - siempre  
am - soy  
an - un  
and - y  
another - otro  
answer - respuesta  
answered - respondido  
answering - respondiendo  
any - cualquier  
anymore - ya no  
anyone - nadie  
anything - nada  
anyway - de todos modos  
anywhere - en cualquier lugar  
apparently - aparentemente  
are - son  
around - alrededor  
as - como  
aside - aparte  
ask - preguntar  
asked - preguntado  
asking - preguntando  
at - en  
away - lejos  
awhile - un rato  
back - atrás  
bad - malo  
badly - mal  
be - ser  
became - se convirtió  
because - porque  
become - convertirse  
been - sido  
before - antes  
began - comenzó  
begin - comenzar  
beginning - comienzo  
begun - comenzado  
behind - detrás  
being - siendo  
believe - creer  
believed - creído  
believing - creyendo  
beside - al lado  
best - mejor  
better - mejor  
between - entre  
beyond - más allá  
big - grande  
bigger - más grande  
block - bloquear  
blocked - bloqueado  
both - ambos  
break - romper  
bring - traer  
brought - traído  
but - pero  
by - por  
call - llamar  
called - llamado  
calling - llamando  
came - vino  
can - poder  
cannot - no puede  
cant - no puede  
care - cuidar  
cared - cuidado  
caring - cuidando  
careful - cuidadoso  
carefully - cuidadosamente  
caught - atrapado  
certain - cierto  
certainly - ciertamente  
chance - oportunidad  
change - cambiar  
changed - cambiado  
changing - cambiando  
check - comprobar  
checked - comprobado  
checking - comprobando  
choose - elegir  
chose - eligió  
chosen - elegido  
clear - claro  
clearly - claramente  
close - cerrar  
closed - cerrado  
closely - de cerca  
closer - más cerca  
come - venir  
comes - viene  
coming - viniendo  
continue - continuar  
continued - continuado  
control - controlar  
controlled - controlado  
controlling - controlando  
could - podría  
couldn't - no podría  
course - curso  
create - crear  
created - creado  
creating - creando  
current - actual  
decide - decidir  
decided - decidido  
depend - depender  
depends - depende  
depending - dependiendo  
despite - a pesar de  
did - hizo  
didn't - no hizo  
different - diferente  
differently - de manera diferente  
difficult - difícil  
do - hacer  
does - hace  
doesn't - no hace  
doing - haciendo  
don't - no  
done - hecho  
doubt - dudar  
doubted - dudado  
doubting - dudando  
down - abajo  
during - durante  
each - cada  
earlier - antes  
early - temprano  
easier - más fácil  
easily - fácilmente  
easy - fácil  
effort - esfuerzo  
either - o  
else - otro  
end - fin  
enough - suficiente  
enter - entrar  
entire - entero  
entirely - completamente  
equal - igual  
even - incluso  
ever - alguna vez  
every - cada  
everyone - todos  
everything - todo  
exact - exacto  
exactly - exactamente  
except - excepto  
expect - esperar  
expected - esperado  
explain - explicar  
explained - explicado  
extra - extra  
fact - hecho  
facts - hechos  
far - lejos  
fast - rápido  
faster - más rápido  
fastest - más rápido  
feel - sentir  
feeling - sentimiento  
feelings - sentimientos  
feels - siente  
felt - sentido  
few - pocos  
final - final  
finally - finalmente  
find - encontrar  
fine - bien  
finish - terminar  
finished - terminado  
first - primero  
follow - seguir  
followed - seguido  
following - siguiendo  
for - para  
found - encontrado  
from - de  
full - lleno  
gave - dio  
general - general  
generally - generalmente  
get - obtener  
gets - obtiene  
getting - obteniendo  
give - dar  
given - dado  
go - ir  
goes - va  
going - yendo  
gone - ido  
good - bueno  
got - consiguió  
gotten - conseguido  
great - genial  
had - tuvo  
hadn't - no tuvo  
happened - sucedido  
happening - sucediendo  
hard - difícil  
hardly - apenas  
has - tiene  
have - tener  
having - teniendo  
he - él  
he'd - él habría  
he's - él está  
heard - oído  
held - sostenido  
help - ayudar  
helped - ayudado  
helping - ayudando  
her - su  
herself - ella misma  
hers - de ella  
here - aquí  
him - él  
himself - él mismo  
his - su  
hold - sostener  
how - cómo  
however - sin embargo  
hurt - herir  
I - yo  
idea - idea  
if - si  
immediately - inmediatamente  
important - importante  
impossible - imposible  
in - en  
instead - en lugar  
interesting - interesante  
into - dentro  
is - es  
isn't - no es  
it - eso  
its - su  
itself - eso mismo  
join - unir  
joined - unido  
joining - uniendo  
just - solo  
keep - mantener  
keeps - mantiene  
keeping - manteniendo  
kept - mantenido  
kind - amable  
knew - sabía  
know - saber  
knowing - sabiendo  
known - conocido  
knows - sabe  
last - último  
lasted - duró  
lasting - duradero  
late - tarde  
later - más tarde  
learn - aprender  
learned - aprendido  
learning - aprendiendo  
least - menos  
leave - dejar  
left - dejado  
less - menos  
let - dejar  
lie - mentir  
lied - mintió  
like - como  
liked - gustó  
likely - probablemente  
likes - le gusta  
listen - escuchar  
little - pequeño  
long - largo  
longer - más largo  
look - mirar  
looked - mirado  
looking - mirando  
looks - mira  
lost - perdido  
lot - mucho  
love - amar  
loved - amado  
loving - amoroso  
made - hecho  
make - hacer  
makes - hace  
making - haciendo  
manage - gestionar  
managed - gestionado  
managing - gestionando  
many - muchos  
matter - asunto  
mattered - importado  
may - puede  
maybe - tal vez  
me - me  
mean - significar  
means - significa  
meant - pretendido  
meet - encontrar  
meeting - reunión  
mere - mero  
merely - simplemente  
met - conocí  
might - podría  
mind - mente  
mine - mío  
minute - minuto  
minuets - minuetes  
mistake - error  
mistaken - equivocado  
mistaking - confundiendo  
moment - momento  
moments - momentos  
more - más  
most - la mayoría  
mostly - mayormente  
move - mover  
moved - movido  
moving - moviendo  
much - mucho  
must - debe  
my - mi  
myself - yo mismo  
near - cerca  
nearby - cercano  
nearly - casi  
need - necesitar  
needed - necesitado  
needing - necesitando  
neither - ninguno  
never - nunca  
new - nuevo  
next - siguiente  
nice - agradable  
no - no  
nobody - nadie  
none - ninguno  
normal - normal  
normally - normalmente  
not - no  
nothing - nada  
notice - notar  
noticed - notado  
now - ahora  
nowhere - en ninguna parte  
number - número  
obvious - obvio  
obviously - obviamente  
occurred - ocurrió  
odd - extraño  
of - de  
off - apagado  
often - a menudo  
old - viejo  
on - en  
once - una vez  
one - uno  
only - solo  
onto - sobre  
open - abrir  
opened - abierto  
or - o  
ordinarily - ordinariamente  
other - otro  
others - otros  
otherwise - de otra manera  
our - nuestro  
out - fuera  
over - sobre  
own - propio  
part - parte  
passed - pasado  
past - pasado  
people - personas  
perhaps - quizás  
person - persona  
place - lugar  
plain - simple  
pleased - complacido  
point - punto  
possible - posible  
possibly - posiblemente  
probably - probablemente  
problem - problema  
put - poner  
quick - rápido  
quickly - rápidamente  
quiet - silencioso  
quit - dejar  
quite - bastante  
ran - corrió  
rather - más bien  
reach - alcanzar  
reached - alcanzado  
ready - listo  
real - real  
realized - realizado  
really - realmente  
reason - razón  
recognize - reconocer  
recognized - reconocido  
remain - permanecer  
remained - permanecido  
remaining - restante  
remember - recordar  
remembered - recordado  
remind - recordar  
reminded - recordado  
repeat - repetir  
repeated - repetido  
repeating - repitiendo  
require - requerir  
required - requerido  
requiring - requiriendo  
rest - descansar  
rested - descansado  
resting - descansando  
return - regresar  
returned - regresado  
returning - regresando  
right - derecho  
said - dicho  
same - mismo  
saw - vio  
say - decir  
saying - diciendo  
says - dice  
search - buscar  
second - segundo  
see - ver  
seeing - viendo  
seem - parecer  
seemed - pareció  
seeming - pareciendo  
seems - parece  
seen - visto  
send - enviar  
sense - sentido  
sent - enviado  
serious - serio  
seriously - seriamente  
set - establecer  
setting - configuración  
several - varios  
share - compartir  
shared - compartido  
sharing - compartiendo  
she - ella  
should - debería  
shouldn't - no debería  
show - mostrar  
showed - mostró  
showing - mostrando  
shown - mostrado  
side - lado  
sight - vista  
sign - signo  
silence - silencio  
simple - simple  
simpler - más simple  
simply - simplemente  
since - desde  
slow - lento  
so - así  
some - algunos  
somehow - de alguna manera  
someone - alguien  
something - algo  
sometimes - a veces  
somewhat - algo  
somewhere - en algún lugar  
soon - pronto  
sooner - más pronto  
sort - tipo  
start - comenzar  
started - comenzado  
starting - comenzando  
stay - quedarse  
stayed - quedado  
staying - quedando  
still - todavía  
stood - se quedó  
stop - detener  
stopped - detenido  
stopping - deteniendo  
such - tal  
sudden - repentino  
suddenly - de repente  
suppose - suponer  
supposed - supuesto  
supposing - suponiendo  
supposedly - supuestamente  
sure - seguro  
surprise - sorpresa  
surprised - sorprendido  
surprising - sorprendente  
take - tomar  
taken - tomado  
taking - tomando  
talked - hablado  
talking - hablando  
tell - contar  
than - que  
that - eso  
that's - eso es  
the - el  
their - su  
them - ellos  
then - entonces  
there - allí  
these - estos  
they - ellos  
they're - ellos son  
thing - cosa  
things - cosas  
think - pensar  
thinking - pensando  
this - esto  
those - aquellos  
though - aunque  
thought - pensamiento  
through - a través  
thus - así  
time - tiempo  
times - veces  
to - a  
together - juntos  
told - contado  
too - también  
took - tomó  
toward - hacia  
tried - intentado  
trouble - problema  
true - verdadero  
try - intentar  
trying - intentando  
turned - convertido  
turning - girando  
type - tipo  
unable - incapaz  
under - debajo  
understand - entender  
understanding - entendimiento  
understood - entendido  
unless - a menos que  
until - hasta  
up - arriba  
upon - sobre  
us - nosotros  
use - usar  
used - usado  
useful - útil  
uses - usos  
using - usando  
usual - habitual  
usually - usualmente  
vary - variar  
very - muy  
wait - esperar  
waited - esperado  
waiting - esperando  
want - querer  
wanted - querido  
was - fue  
wasn't - no fue  
watch - ver  
watched - mirado  
watching - mirando  
way - manera  
ways - maneras  
we - nosotros  
well - bien  
went - fue  
were - fueron  
weren't - no fueron  
what - qué  
what's - qué es  
whatever - lo que sea  
whatsoever - en absoluto  
when - cuándo  
where - dónde  
wherever - dondequiera  
whether - si  
which - cuál  
while - mientras  
who - quién  
whoever - quienquiera  
whole - entero  
whom - a quién  
whose - cuyo  
why - por qué  
will - voluntad  
with - con  
within - dentro de  
without - sin  
won't - no lo hará  
wonder - preguntar  
word - palabra  
words - palabras  
work - trabajar  
worked - trabajado  
working - trabajando  
worse - peor  
worst - el peor  
worth - valor  
would - haría  
wouldn't - no haría  
wrong - equivocado  
year - año  
years - años  
yeah - sí
yes - sí  
yet - todavía  
you - tú  
you'd - tu lo harías
you'll -  tu lo harás
you're - estás
you've - tu has
your - su
yours - tuyo
yourself - tú mismo
