a - un/a  
about - acerca de  
above - sobre  
actual - actual  
actually - en realidad  
after - después  
again - otra vez  
against - contra  
ago - hace  
agree - estar de acuerdo  
agreed - acordado  
all - todo  
allow - permitir  
allowed - permitido  
allowing - permitiendo  
almost - casi  
already - ya  
also - también  
although - aunque  
always - siempre  
am - soy/estoy  
among - entre  
an - un/a  
and - y  
another - otro/a  
answer - respuesta  
answered - respondido  
answering - respondiendo  
any - cualquiera  
anymore - ya no  
anyone - cualquiera  
anything - cualquier cosa  
anyway - de todos modos  
anywhere - en cualquier lugar  
apparent - aparente  
apparently - aparentemente  
appear - aparecer 
appearing
appears
are - son/están    
around - alrededor  
as - como  
aside - a un lado  
ask - preguntar  
asked - preguntado  
asking - preguntando  
at - en  
away - lejos  
awhile - un rato  
back - atrás  
bad - malo  
badly - mal  
be - ser/estar  
became - se convirtió  
because - porque  
become - convertirse  
been - sido/estado  
before - antes  
began - comenzó  
begin - comenzar  
beginning - comienzo  
begun - comenzado  
behind - detrás  
being - siendo  
believe - creer  
believed - creído  
believing - creyendo  
beside - al lado de  
best - mejor  
better - mejor  
between - entre  
beyond - más allá  
big - grande  
bigger - más grande
block - bloquear  
blocked - bloqueado  
both - ambos    
bring - traer  
brought - traído  
busy - ocupado  
but - pero  
by - por  
call - llamar  
called - llamado  
calling - llamando  
came - vino  
can - poder  
cannot - no puede  
cant - no puede  
care - cuidar  
cared - cuidado  
careful - cuidadoso  
carefully - cuidadosamente  
caring - cuidando  
caught - atrapado  
certain - cierto  
certainly - ciertamente  
chance - oportunidad  
change - cambiar  
changed - cambiado  
changing - cambiando  
check - comprobar  
checked - comprobado  
checking - comprobando  
choose - elegir  
chose - eligió  
chosen - elegido  
clear - claro  
clearly - claramente  
close - cerrar  
closed - cerrado  
closely - de cerca  
closer - más cerca  
come - venir  
comes - viene  
coming - viniendo  
common - común  
complete - completar
completely  
continue - continuar  
continued - continuado  
control - controlar  
controlled - controlado  
controlling - controlando  
could - podría  
couldn't - no podría  
course - curso  
create - crear  
created - creado  
creating - creando  
current - actual  
currently - actualmente  
decide - decidir  
decided - decidido  
depend - depender  
depends - depende  
depending - dependiendo  
despite - a pesar de  
develop - desarrollar
developed
did - hizo  
didn't - no hizo  
different - diferente  
differently - de manera diferente  
difficult - difícil  
do - hacer  
does - hace  
doesn't - no hace  
doing - haciendo  
don't - no  
done - hecho  
doubt - dudar  
doubted - dudado  
doubting - dudando  
down - abajo  
during - durante  
each - cada  
earlier - más temprano  
early - temprano  
easier - más fácil  
easily - fácilmente  
easy - fácil  
effort - esfuerzo  
either - tampoco/cualquiera  
else - más  
end - fin  
enough - suficiente  
enter - entrar  
entire - entero  
entirely - completamente  
equal - igual  
even - incluso  
ever - alguna vez  
every - cada  
everyone - todos  
everything - todo  
example - ejemplo  
exact - exacto  
exactly - exactamente  
except - excepto  
expect - esperar  
expected - esperado  
expecting - esperando  
explain - explicar  
explained - explicado  
explaining - explicando  
extra - extra  
false - falso  
fact - hecho  
far - lejos  
fast - rápido  
faster - más rápido  
fastest - el más rápido  
feel - sentir  
feeling - sentimiento  
feelings - sentimientos  
feels - siente  
felt - sentido  
few - pocos/as  
final - final  
finally - finalmente  
find - encontrar  
fine - bien  
finish - terminar  
finished - terminado
finishing
first - primero  
follow - seguir  
followed - seguido  
following - siguiendo  
for - para  
found - encontrado  
from - desde  
full - lleno  
gave - dio  
general - general  
generally - generalmente  
get - obtener  
gets - obtiene  
getting - obteniendo  
give - dar  
given - dado
giving
go - ir  
goes - va  
going - yendo  
gone - ido  
good - bueno  
got - consiguió  
gotten - conseguido  
great - genial  
guy - chico  
had - tenía  
hadn't - no tenía  
half - mitad  
happen - ocurrir  
happened - ocurrió  
happening - ocurriendo  
has - tiene  
hasn't - no tiene  
have - tener  
haven't - no he/has  
having - teniendo  
he - él  
head - cabeza  
hear - oír  
heard - oído  
hearing - oyendo  
help - ayudar  
helped - ayudado  
helping - ayudando  
helps - ayuda  
her - su/ella  
here - aquí  
him - él  
himself - él mismo  
his - su  
hold - sostener  
holding - sosteniendo  
home - hogar  
hope - esperanza  
hoped - esperó  
hopes - esperanzas  
hoping - esperando  
how - cómo  
however - sin embargo  
huge - enorme  
I - yo  
if - si  
imagine - imaginar  
imagined - imaginado  
imagining - imaginando  
immediate - inmediato  
immediately - inmediatamente  
important - importante  
impossible - imposible  
in - en  
include - incluir  
included - incluido  
includes - incluye  
including - incluyendo  
instead - en lugar de  
is - es/está  
it - eso  
its - su  
itself - sí mismo  
just - justo  
keep - mantener  
kept - mantenido  
knew - sabía  
know - saber  
knowing - sabiendo  
known - conocido  
knows - sabe  
large - grande  
last - último  
late - tarde  
later - más tarde  
least - menos  
leave - salir  
left - salió  
less - menos  
let - dejar  
lets - deja   
like - gustar  
likely - probablemente    
little - poco  
live - vivir  
lived - vivido  
living - viviendo  
long - largo  
longer - más largo  
longest
look - mirar  
looked - miró  
looking - mirando  
looks - mira  
lot - mucho  
love - amor  
loved - amado  
loves - ama  
loving - amando  
lucky - afortunado 
made - hecho  
main - principal  
make - hacer  
makes - hace  
making - haciendo  
man - hombre  
many - muchos  
may - puede  
maybe - tal vez  
me - mí  
mean - significar  
means - significa  
meant - significó  
men - hombres  
mention - mencionar  
mentioned - mencionado  
mentioning - mencionando  
might - podría    
mind - mente  
mine - mío  
miss - extrañar  
moment - momento   
more - más  
most - la mayoría  
move - mover  
moved - movido  
moving - moviendo  
much - mucho  
must - debe  
my - mi  
myself - yo mismo  
name - nombre  
named - llamado  
names - nombres  
naming - nombrando  
near - cerca  
necessary - necesario  
need - necesitar  
needed - necesitado  
needing - necesitando  
needs - necesita  
neither - ninguno  
never - nunca  
new - nuevo  
next - siguiente  
nice - agradable  
night - noche  
no - no  
nobody - nadie  
none - ninguno  
nor - ni  
not - no  
nothing - nada  
notice - notar  
noticed - notado  
noticing - notando  
now - ahora  
number - número  
numbers - números   
obvious - obvio  
obviously - obviamente  
of - de  
off - apagado  
often - a menudo  
oh - oh  
on - en  
once - una vez  
one - uno  
only - solo  
onto - sobre  
open - abrir  
opened - abierto  
opening - abriendo  
opinion - opinión  
or - o  
order - ordenar  
ordered - ordenado  
ordering - ordenando  
original - original  
originally - originalmente  
other - otro  
others - otros  
our - nuestro  
out - fuera  
outside - afuera  
over - encima  
own - propio  
pair - par  
part - parte  
particular - particular  
particularly - particularmente  
pass - pasar  
passed - pasado  
passing - pasando  
past - pasado  
perhaps - quizás  
person - persona  
personal - personal  
plan - plan  
planned - planeado  
planning - planificando  
play - jugar  
played - jugado  
playing - jugando  
please - por favor  
point - punto  
points - puntos  
poor - pobre  
possible - posible  
possibly - posiblemente  
practice - práctica  
prepare - preparar  
prepared - preparado  
preparing - preparando  
present - presente  
probably - probablemente  
problem - problema  
process - proceso  
provide - proporcionar  
provided - proporcionado  
providing - proporcionando   
purpose - propósito  
put - poner  
puts - pone  
putting - poniendo  
question - pregunta  
questions - preguntas  
quick - rápido  
quickly - rápidamente  
quiet - tranquilo  
quite - bastante  
rather - bastante  
reach - alcanzar  
reached - alcanzado  
reaching - alcanzando  
ready - listo  
real - real  
really - realmente  
reason - razón  
receive - recibir  
received - recibido  
receiving - recibiendo  
recent - reciente  
recently - recientemente  
recognize - reconocer  
recognized - reconocido  
recognizing - reconociendo   
remember - recordar  
remembered - recordado  ²  
remembering - recordar  
repeat - repetir  
repeated - repetido  
repeating - repitiendo  
rest - descansar  
rested - descansado  
resting - descansando  
result - resultado  
results - resultados  
return - volver  
returned - vuelto  
returning - volviendo  
right - derecho  
room - habitación  
run - correr  
ran - corrió  
running - corriendo  
runs - corre  
said - dijo  
same - mismo  
saw - vio  
say - decir  
saying - diciendo  
says - dice  
self - uno mismo  
send - enviar  
sent - enviado  
sense - sentido    
separate - separar  
separated - separado  
separating - separando  
set - establecer  
sets - establece  
setting - estableciendo  
shall - deberá  
she - ella  
short - corto  
shorter - más corto  
shortest - el más corto  
should - debería 
shouldn't
show - mostrar  
showed - mostró  
showing - mostrando  
shows - muestra  
shut - cerrar  
shutting - cerrando  
side - lado  
since - desde  
small - pequeño  
smaller - más pequeño  
smallest - el más pequeño  
so - así  
some - algunos  
somebody - alguien  
someone - alguien  
something - algo  
sometimes - a veces  
somewhere - en algún lugar  
soon - pronto  
special - especial  
specific - específico  
specifically - específicamente  
spent - gastado  
start - comenzar  
started - comenzado  
starting - comenzando  
starts - comienza  
state - estado  
stated - declarado  
stating - declarando  
stay - quedarse  
stayed - quedado  
staying - quedándose  
still - todavía  
stood - se paró  
stop - detener  
stopped - detenido  
stopping - deteniendo  
strong - fuerte  
stronger - más fuerte  
strongest - el más fuerte  
such - tal  
suggest - sugerir  
suggested - sugerido  
suggesting - sugiriendo  
sure - seguro  
surely - seguramente    
take - tomar  
taken - tomado  
takes - toma  
taking - tomando  
talk - hablar  
talked - habló  
talking - hablando  
talks - habla    
tell - decir  
telling - diciendo  
tells - dice  
than - que  
thank - agradecer  
thanked - agradecido  
thanking - agradeciendo  
thanks - gracias  
that - eso  
the - el/la  
their - su  
them - ellos  
themselves - ellos mismos  
then - entonces  
there - allí  
these - estos  
they - ellos  
thing - cosa  
things - cosas  
think - pensar  
thinking - pensando  
thinks - piensa  
this - esto  
those - esos  
though - aunque  
thought - pensamiento  
thoughts - pensamientos    
through - a través de  
time - tiempo  
times - tiempos  
to - a  
together - juntos  
told - dijo  
too - también  
took - tomó   
toward - hacia  
towards - hacia  
tried - intentó  
tries - intenta  
trying - intentando  
true - verdadero  
truly - verdaderamente  
trust - confiar  
trusted - confiado  
trusting - confiando  
truth - verdad  
turn - girar  
turned - girado  
turning - girando  
turns - giros  
two - dos  
under - debajo  
understand - entender  
understood - entendido  
understanding - entendiendo  
until - hasta  
up - arriba  
upon - sobre  
us - nosotros  
use - usar  
used - usado  
uses - usa  
using - usando  
usual - usual  
usually - usualmente  
value - valor  
various - varios  
very - muy  
view - vista  
views - vistas  
visit - visitar  
visited - visitado  
visiting - visitando  
voice - voz  
voices - voces  
wait - esperar  
waited - esperado  
waiting - esperando  
walk - caminar  
walked - caminó  
walking - caminando  
walks - camina  
want - querer  
wanted - querido  
wanting - queriendo  
wants - quiere  
was - fue  
watch - mirar  
watched - miró  
watching - mirando  
way - camino  
ways - caminos  
we - nosotros  
wear - llevar  
wearing - llevando    
well - bien  
went - fue  
were - eran  
what - qué  
when - cuándo  
where - dónde  
whether - si  
which - cuál  
while - mientras  
white - blanco  
who - quién  
whole - todo  
whose - cuyo  
why - por qué  
will - voluntad  
wish - desear  
wished - deseado  
wishes - deseos  
wishing - deseando  
with - con  
within - dentro  
without - sin  
woman - mujer  
women - mujeres  
word - palabra  
words - palabras  
work - trabajar  
worked - trabajado  
working - trabajando  
works - trabaja  
world - mundo  
would - haría  
write - escribir  
writing - escribiendo  
wrote - escribió  
written - escrito  
wrong - equivocado  
year - año  
years - años  
yes - sí  
yet - aún  
you - tú  
young - joven  
your - tu  
yourself - tú mismo  
