Here’s the list with the Spanish translations next to each English word:

a - un/una
about - sobre
above - encima de
accept - aceptar
accepted - aceptado
accepting - aceptando
accepts - acepta
according - según
across - a través de
actual - actual
actually - en realidad
affect - afectar
after - después
again - otra vez
against - contra
ago - hace
agree - estar de acuerdo
agreed - acordado
agreeing - acordando
ahead - adelante
all - todo
allow - permitir
allowed - permitido
allowing - permitiendo
almost - casi
alone - solo
along - a lo largo de
already - ya
also - también
although - aunque
always - siempre
am - soy/estoy
among - entre
amount - cantidad
an - un/una
and - y
another - otro
answer - respuesta
answered - respondido
answering - respondiendo
answers - respuestas
any - cualquier
anymore - ya no
anyone - alguien
anything - cualquier cosa
anyway - de todos modos
anywhere - en cualquier lugar
apart - aparte
apparent - aparente
apparently - aparentemente
approach - acercarse
approve - aprobar
are - son/están
around - alrededor
as - como
aside - a un lado
ask - preguntar
asked - preguntado
asking - preguntando
asks - pregunta
assume - suponer
at - en
aware - consciente
away - lejos
awful - horrible
awhile - un rato
back - atrás
bad - malo
badly - mal
basic - básico
basically - básicamente
be - ser/estar
became - se convirtió
because - porque
become - convertirse
becomes - se convierte
becoming - convirtiéndose
been - sido/estado
before - antes
began - comenzó
begin - comenzar
beginning - comienzo
begun - comenzado
behind - detrás
being - siendo
belief - creencia
believe - creer
believed - creído
believing - creyendo
believes - cree
belong - pertenecer
belonged - pertenecido
belonging - perteneciente
belongs - pertenece
below - debajo
beside - al lado de
besides - además de
best - mejor
better - mejor
between - entre
beyond - más allá de
big - grande
bigger - más grande
both - ambos
broke - rompió
broken - roto
brought - traído
brings - trae
bring - traer
building - edificio
build - construir
built - construido
bought - comprado
buying - comprando
buys - compra
but - pero
by - por
call - llamar
called - llamado
calling - llamando
calls - llama
came - vino
can - poder
can't - no puede
cannot - no puede
care - cuidar
cared - cuidado
careful - cuidadoso
carefully - cuidadosamente
careless - descuidado
case - caso
cause - causa
caused - causado
causing - causando
certain - cierto
certainly - ciertamente
chance - oportunidad
change - cambiar
changed - cambiado
changing - cambiando
check - comprobar
checked - comprobado
checking - comprobando
choice - elección
choose - elegir
chose - eligió
chosen - elegido
clear - claro
clearly - claramente
close - cerca
closed - cerrado
closely - de cerca
closer - más cerca
come - venir
comes - viene
coming - viniendo
common - común
compare - comparar
completed - completado
completing - completando
completes - completa
consider - considerar
considered - considerado
considering - considerando
considers - considera
control - controlar
controlled - controlado
controlling - controlando
could - podría
couldn't - no podría
course - curso
create - crear
created - creado
creating - creando
creates - crea
current - actual
currently - actualmente
decide - decidir
decided - decidido
decision - decisión
depend - depender
depending - dependiendo
dependent - dependiente
depends - depende
despite - a pesar de
develop - desarrollar
developed - desarrollado
did - hizo
didn't - no hizo
different - diferente
differently - de manera diferente
difficult - difícil
do - hacer
does - hace
doesn't - no hace
doing - haciendo
don't - no
done - hecho
doubt - dudar
doubted - dudado
doubting - dudando
down - abajo
during - durante
each - cada
earlier - más temprano
early - temprano
easier - más fácil
easily - fácilmente
easy - fácil
effect - efecto
effort - esfuerzo
either - cualquiera
else - otro
end - final
enjoy - disfrutar
enjoyed - disfrutado
enjoying - disfrutando
enjoys - disfruta
enough - suficiente
enter - entrar
entire - entero
entirely - completamente
equal - igual
especially - especialmente
even - incluso
ever - alguna vez
every - cada
everyone - todos
everything - todo
exact - exacto
exactly - exactamente
example - ejemplo
except - excepto
expect - esperar
expected - esperado
expecting - esperando
explain - explicar
explained - explicado
explaining - explicando
explanation - explicación
extra - extra
fail - fallar
failed - fallado
failure - fracaso
false - falso
far - lejos
fast - rápido
faster - más rápido
fastest - el más rápido
feel - sentir
feeling - sentimiento
feelings - sentimientos
feels - siente
felt - sentido
few - pocos
final - final
finally - finalmente
find - encontrar
finds - encuentra
finish - terminar
finished - terminado
finishing - terminando
first - primero
for - para
found - encontrado
free - libre
from - de
full - lleno
gave - dio
general - general
generally - generalmente
get - obtener
gets - obtiene
getting - obteniendo
girl - chica
give - dar
given - dado
giving - dando
go - ir
goes - va
going - yendo
gone - ido
good - bueno
got - obtuvo
gotten - obtenido
great - grande
guess - adivinar
guy - chico
had - tenía
hadn't - no tenía
half - mitad
happen - suceder
happened - sucedido
happening - sucediendo
hard - difícil
hardly - apenas
has - tiene
hasn't - no tiene
have - tener
haven't - no he tenido
having - teniendo
he - él
head - cabeza
hear - oír
heard - oído
hearing - oyendo
held - sostenido
help - ayudar
helped - ayudado
helping - ayudando
helps - ayuda
her - su
here - aquí
hers - suya
herself - ella misma
him - lo/le
himself - él mismo
his - su
hold - sostener
holding - sosteniendo
hope - esperanza
hoped - esperado
hopes - espera
hoping - esperando
hopeful - esperanzado
hopeless - sin esperanza
how - cómo
however - sin embargo
huge - enorme
I - yo
idea - idea
if - si
imagine - imaginar
imagined - imaginado
imagining - imaginando
immediate - inmediato
immediately - inmediatamente
important - importante
impossible - imposible
improve - mejorar
improvement - mejora
in - en
include - incluir
included - incluido
includes - incluye
including - incluyendo
instead - en lugar de
interesting - interesante
into - en
is - es/está
isn't - no es/no está
it - eso
its - su
itself - él mismo/ella misma
join - unirse
just - justo
keep - mantener
kept - mantenido
kind - amable
knew - sabía
know - saber
knowing - sabiendo
known - conocido
knows - sabe
large - grande
last - último
lasted - duró
late - tarde
lately - últimamente
later - más tarde
least - menos
leave - dejar
left - izquierdo
less - menos
let - permitir
lets - deja
lie - mentir/reclinar
lied - mintió
like - gustar
liked - gustado
likely - probable
little - pequeño
live - vivir
lived - vivido
living - viviendo
long - largo
longer - más largo
longest - el más largo
look - mirar
looked - mirado
looking - mirando
looks - mira
lot - mucho
love - amar
loved - amado
loves - ama
loving - amoroso
lucky - afortunado
made - hecho
main - principal
major - mayor
make - hacer
makes - hace
making - haciendo
man - hombre
managed - manejado
many - muchos
matter - asunto
mattered - importado
may - puede
maybe - tal vez
me - me
mean - significar
means - medios
meant - destinado
meet - conocer
mentioned - mencionado
mentioning - mencionando
might - podría
mind - mente
mine - mío
miss - extrañar
moment - momento
more - más
most - la mayoría
mostly - mayormente
move - mover
moved - movido
moving - moviendo
much - mucho
must - debe
my - mi
myself - yo mismo
name - nombre
named - llamado
names - nombres
naming - nombrando
near - cerca
nearly - casi
necessary - necesario
need - necesitar
needed - necesitado
needing - necesitando
needs - necesita
neither - ninguno
never - nunca
new - nuevo
next - siguiente
nice - agradable
no - no
nobody - nadie
none - ninguno
nor - ni
normally - normalmente
not - no
nothing - nada
notice - notar
noticed - notado
noticing - notando
noticeable - notorio
now - ahora
nowhere - en ninguna parte
obvious - obvio
obviously - obviamente
occur - ocurrir
of - de
off - apagado
offer - ofrecer
often - a menudo
oh - oh
ok - está bien
on - en
once - una vez
one - uno
only - solo
onto - sobre
opinion - opinión
or - o
original - original
originally - originalmente
other - otro
others - otros
otherwise - de lo contrario
our - nuestro
out - fuera
outside - afuera
over - sobre
own - propio
pair - par
part - parte
particular - particular
particularly - particularmente
pass - pasar
passed - pasado
passing - pasando
past - pasado
people - gente
perhaps - quizás
person - persona
pick - escoger
place - lugar
plan - plan
planned - planeado
planning - planeando
please - por favor
poor - pobre
possible - posible
possibly - posiblemente
present - presente
prepare - preparar
probably - probablemente
problem - problema
problems - problemas
purpose - propósito
put - poner
puts - pone
putting - poniendo
question - pregunta
questions - preguntas
quick - rápido
quickly - rápidamente
quiet - tranquilo
quit - dejar
quite - bastante
raise - levantar
rather - más bien
reach - alcanzar
reached - alcanzado
reaching - alcanzando
ready - listo
real - real
realize - darse cuenta
really - realmente
reason - razón
recent - reciente
recently - recientemente
remain - permanecer
remained - permanecido
remaining - permaneciendo
require - requerir
required - requerido
requiring - requiriendo
result - resultado
results - resultados
return - regresar
returned - regresado
returning - regresando
right - correcto
said - dicho
same - mismo
saw - vio
say - decir
saying - diciendo
says - dice
see - ver
seek - buscar
seem - parecer
seemed - pareció
seeming - pareciendo
seems - parece
self - uno mismo
send - enviar
sending - enviando
sense - sentido
sent - enviado
serious - serio
seriously - seriamente
set - conjunto
sets - pone
setting - configuración
several - varios
shall - deber
share - compartir
shared - compartido
sharing - compartiendo
she - ella
should - deberia
shouldn't - no debería
show - mostrar
showed - mostró
showing - mostrando
shows - muestra
side - lado
simple - simple
simpler - más simple
simply - simplemente
since - desde
small - pequeño
smaller - más pequeño
smallest - el más pequeño
so - así que
some - algunos
somebody - alguien
someone - alguien
something - algo
sometimes - a veces
somewhat - algo
somewhere - en algún lugar
soon - pronto
sooner - más pronto
sort - tipo
special - especial
specific - específico
specifically - específicamente
spent - gastado
start - empezar
started - empezado
starting - empezando
starts - empieza
still - todavía
stood - estuvo de pie
stop - parar
stopped - detenido
stopping - parando
strong - fuerte
stronger - más fuerte
strongest - el más fuerte
such - tal
success - éxito
successful - exitoso
succeed - tener éxito
sudden - repentino
suddenly - de repente
suppose - suponer
supposed - supuesto
sure - seguro
surely - seguramente
take - tomar
taken - tomado
takes - toma
taking - tomando
talk - hablar
talked - hablado
talking - hablando
talks - habla
tell - decir
telling - contando
tells - dice
tend - tender
than - que
thank - agradecer
thanked - agradecido
thanking - agradeciendo
thanks - gracias
that - eso
that's - eso es
the - el/la
their - su
them - ellos
themselves - ellos mismos
then - luego
there - allí
these - estos
they - ellos
they'll - ellos lo harán
they're - ellos están
thing - cosa
things - cosas
think - pensar
thinking - pensando
thinks - piensa
this - esto
those - aquellos
though - aunque
thought - pensamiento
thoughts - pensamientos
through - a través de
to - a
together - juntos
told - dijo
too - demasiado
took - tomó
toward - hacia
towards - hacia
tried - intentado
tries - intenta
trouble - problema
true - verdadero
truly - verdaderamente
try - intentar
trying - intentando
unable - incapaz
understand - entender
understanding - entendimiento
understood - entendido
unless - a menos que
until - hasta
up - arriba
upon - sobre
us - nosotros
use - usar
used - usado
useful - útil
useless - inútil
uses - usa
using - usando
usual - usual
usually - usualmente
value - valor
valued - valorado
various - varios
very - muy
wait - esperar
waited - esperado
waiting - esperando
want - querer
wanted - querido
wanting - queriendo
wants - quiere
was - era/estaba
wasn't - no era/no estaba
way - camino
ways - maneras
we - nosotros
well - bien
went - fue
were - fueron
weren't - no fueron
what - qué
whatever - lo que sea
whatsoever - en absoluto
when - cuándo
where - dónde
wherever - dondequiera
whether - si
which - cuál
while - mientras
who - quién
whoever - quienquiera
whole - todo
whom - a quién
whose - cuyo
why - por qué
will - voluntad
wish - desear
wished - deseado
wishes - deseos
wishing - deseando
with - con
within - dentro
without - sin
woman - mujer
women - mujeres
won't - no lo hará
wonder - preguntarse
wonderful - maravilloso
work - trabajar
worked - trabajado
working - trabajando
works - trabajos
worst - peor
worth - valor
would - haría
wouldn't - no haría
wrong - equivocado
yeah - sí
yes - sí
yet - aún
you - tú
you'd - tú lo harías
you'll - tú lo harás
you're - tú estás
you've - tú has
your - tu
yours - tuyo
yourself - tú mismo

